wwwwwwwwwwwwwwwwwwwwwwwwwwwwwwwwwwwwwwwwwwwwwwwwwwwwwwwwwwwwwwwwwwwwwwwwwwwwwwwwwwwwwwwwwwwwwwwwwwww
wwwwwwwwwwwwwwwwwwwwwwwwwwwwwwwwwwwwwwwwwwwwwwwwwwwwwwwwwwwwwwwwwwwwwwwwwwwwwwwwwwwwwwwwwwwwwwwwwwww
ww................................................................................................ww
ww................................................................................................ww
ww................................................................................................ww
ww................................................................................................ww
ww................................................................................................ww
ww................................................................................................ww
ww................................................................................................ww
ww................................................................................................ww
ww................................................................................................ww
ww................................................................................................ww
ww................................................................................................ww
ww................................................................................................ww
ww................................................................................................ww
ww................................................................................................ww
ww................................................................................................ww
ww................................................................................................ww
ww................................................................................................ww
ww................................................................................................ww
ww................................................................................................ww
ww...........wwwwwwwwwwwwwwwwwwwwwwwwwwwwwwwwwwwwwwwwwwwwwwwwww...................................ww
ww...........wwwwwwwwwwwwwwwwwwwwwwwwwwwwwwwwwwwwwwwwwwwwwwwwww...................................ww
ww...........ww..............................................ww...................................ww
ww...........ww..............................................ww...................................ww
ww...........ww..............................................ww...................................ww
ww...........ww..............................................ww...................................ww
ww...........ww..............................................ww...................................ww
ww...........ww..............................................ww...................................ww
ww...........ww..............................................ww...................................ww
ww...........ww..............................................ww...................................ww
ww...........ww..............................................ww...................................ww
ww...........ww..............................................ww...................................ww
ww...........ww..............................................ww...................................ww
ww...........ww..............................................ww...................................ww
ww...........................................................ww...................................ww
ww...........................................................ww...................................ww
ww...........................................................ww...................................ww
ww...........................................................ww...................................ww
ww...........ww..............................................ww...................................ww
ww...........ww..............................................ww...................................ww
ww...........ww..............................................ww...................................ww
ww...........ww..............................................ww...................................ww
ww...........ww..............................................ww...................................ww
ww...........ww..............................................ww...................................ww
ww...........ww..............................................ww...................................ww
ww...........ww..............................................ww...................................ww
ww...........ww..............................................ww...................................ww
ww...........ww..............................................ww...................................ww
ww...........ww..............................................ww...................................ww
ww...........ww..............................................ww...................................ww
ww...........ww..............................................ww...................................ww
ww...........ww..............................................ww...................................ww
ww...........ww..............................................ww...................................ww
ww...........ww..............................................ww...................................ww
ww...........ww..............................................ww...................................ww
ww...........ww..............................................ww...................................ww
ww...........ww..............................................ww...................................ww
ww...........ww..............................................ww...................................ww
ww...........ww..............................................ww...................................ww
ww...........ww..............................................ww...................................ww
ww...........ww..............................................ww...................................ww
ww...........ww..............................................ww...................................ww
ww...........ww..............................................ww...................................ww
ww...........ww..............................................ww...................................ww
ww...........ww..............................................ww...................................ww
ww...........ww..............................................ww...................................ww
ww...........ww..............................................ww...................................ww
ww...........ww..............................................ww...................................ww
ww...........ww..............................................ww...................................ww
ww...........ww..............................................ww...................................ww
ww...........ww..............................................ww...................................ww
ww...........ww..............................................ww...................................ww
ww...........wwwwwwwwwwwwwwwwwwwwwwwwwwwwwwwwwwwwwwwwwwwwwwwwww...................................ww
ww...........wwwwwwwwwwwwwwwwwwwwwwwwwwwwwwwwwwwwwwwwwwwwwwwwww...................................ww
ww................................................................................................ww
ww................................................................................................ww
ww................................................................................................ww
ww................................................................................................ww
ww................................................................................................ww
ww................................................................................................ww
ww................................................................................................ww
ww................................................................................................ww
ww................................................................................................ww
ww................................................................................................ww
ww................................................................................................ww
ww................................................................................................ww
ww................................................................................................ww
ww................................................................................................ww
ww................................................................................................ww
ww................................................................................................ww
ww................................................................................................ww
ww................................................................................................ww
ww................................................................................................ww
ww................................................................................................ww
ww................................................................................................ww
ww................................................................................................ww
ww................................................................................................ww
wwwwwwwwwwwwwwwwwwwwwwwwwwwwwwwwwwwwwwwwwwwwwwwwwwwwwwwwwwwwwwwwwwwwwwwwwwwwwwwwwwwwwwwwwwwwwwwwwwww
wwwwwwwwwwwwwwwwwwwwwwwwwwwwwwwwwwwwwwwwwwwwwwwwwwwwwwwwwwwwwwwwwwwwwwwwwwwwwwwwwwwwwwwwwwwwwwwwwwww